This is the layout of my keyboard!

┌───────┬───────┬───────┬───────┬───────┬───────┬───────┬───────┬───────┬───────┬───────┬───────┬───────┬───────────────┐
│       │       │       │       │       │       │       │       │       │       │       │       │       │               │
│ `~    │ 1!    │ 2@    │ 3#    │ 4$    │ 5%    │ 6^    │ 7&    │ 8*    │ 9(    │ 0)    │ -_    │ =+    │     Backspace │
├───────┴───┬───┴───┬───┴───┬───┴───┬───┴───┬───┴───┬───┴───┬───┴───┬───┴───┬───┴───┬───┴───┬───┴───┬───┴───┬───────────┤
│           │       │       │       │       │       │       │       │       │       │       │       │       │           │
│ Tab       │ qQ    │ wW    │ eE    │ rR    │ tT    │ yY    │ uU    │ iI    │ oO    │ pP    │ [{    │ ]}    │ \|        │
├───────────┴─┬─────┴─┬─────┴─┬─────┴─┬─────┴─┬─────┴─┬─────┴─┬─────┴─┬─────┴─┬─────┴─┬─────┴─┬─────┴─┬─────┴───────────┤
│             │       │       │       │       │       │       │       │       │       │       │       │                 │
│ Control     │ aA    │ sS    │ dD    │ fF    │ gG    │ hH    │ jJ    │ kK    │ lL    │ ;:    │ '"    │          Return │
├─────────────┴───┬───┴───┬───┴───┬───┴───┬───┴───┬───┴───┬───┴───┬───┴───┬───┴───┬───┴───┬───┴───┬───┴─────────────────┤
│                 │       │       │       │       │       │       │       │       │       │       │                     │
│ Shift           │ zZ    │ xX    │ cC    │ vV    │ bB    │ nN    │ mM    │ ,<    │ .>    │ /?    │             Level 3 │
├─────────┬───────┴─┬─────┴───┬───┴───────┴───────┴───────┴───────┴───────┴─────┬─┴───────┼───────┴─┬─────────┬─────────┤
│         │         │         │                                                 │         │         │         │         │
│ Escape  │ Alt     │ Super   │                      Space                      │         │         │         │         │
└─────────┴─────────┴─────────┴─────────────────────────────────────────────────┴─────────┴─────────┴─────────┴─────────┘
