This is the layout of my keyboard!

┌───────┬───────┬───────┬───────┬───────┬───────┬───────┬───────┬───────┬───────┬───────┬───────┬───────┬───────────────┐
│       │       │       │       │       │       │       │       │       │       │       │       │       │               │
│ `~    │ 1!    │ 2@    │ 3#    │ 4$    │ 5%    │ 6^    │ 7&    │ 8*    │ 9(    │ 0)    │ -_    │ =+    │     Backspace │
├───────┴───┬───┴───┬───┴───┬───┴───┬───┴───┬───┴───┬───┴───┬───┴───┬───┴───┬───┴───┬───┴───┬───┴───┬───┴───┬───────────┤
│           │       │       │    ε  │       │       │       │       │       │       │       │       │       │           │
│ Tab       │ qQ    │ wW    │ eE ϵΕ │ rR ρΡ │ tT τΤ │ yY υΥ │ uU θΘ │ iI ιΙ │ oO οΟ │ pP πΠ │ [{    │ ]}    │ \|        │
├───────────┴─┬─────┴─┬─────┴─┬─────┴─┬─────┴─┬─────┴─┬─────┴─┬─────┴─┬─────┴─┬─────┴─┬─────┴─┬─────┴─┬─────┴───────────┤
│             │       │    ς  │       │    φ  │       │       │       │       │       │       │       │                 │
│ Control     │ aA αΑ │ sS σΣ │ dD δΔ │ fF ϕΦ │ gG γΓ │ hH ηΗ │ jJ ξΞ │ kK κΚ │ lL λΛ │ ;:    │ '"    │          Return │
├─────────────┴───┬───┴───┬───┴───┬───┴───┬───┴───┬───┴───┬───┴───┬───┴───┬───┴───┬───┴───┬───┴───┬───┴─────────────────┤
│                 │       │       │       │       │       │       │       │       │       │       │                     │
│ Shift           │ zZ ζΖ │ xX χΧ │ cC ψΨ │ vV ωΩ │ bB βΒ │ nN νΝ │ mM μΜ │ ,<    │ .>    │ /?    │             Level 3 │
├─────────┬───────┴─┬─────┴───┬───┴───────┴───────┴───────┴───────┴───────┴─────┬─┴───────┼───────┴─┬─────────┬─────────┤
│         │         │         │                                                 │         │         │         │         │
│ Escape  │ Alt     │ Super   │                      Space                      │         │         │         │         │
└─────────┴─────────┴─────────┴─────────────────────────────────────────────────┴─────────┴─────────┴─────────┴─────────┘
